ANC	A EH N S E
AUV	A U V E
CMACGM	S E EH M A S E J E EH M
ENSTA	EU EH N EH S T E A
EVP	EU V E P E
IUEM	I U EU EH M
OMI	O EH M I
ONU	O N U
PH	P E A CH
SNSM	EH S EH N EH S EH M
UNESCO	U N EH S K O
ZEE	Z EH D EU EU
AFPS	A EH F P E EH S
UJFP	U J I EH F P E
IFREMER	I F R E M EH R
IFREMER	I F R EU M EH R
COM K OH M
WWW W E W E W E
WWW W OE W OE W OE
BZH B E Z E D A CH
