nebeud	nebeut
office	ofis
million	milion
choari	c'hoari
àr	war
àrnezhe	warnezhe
bezaén	bezañ
nebuet	nebeut
france	frañs
peseut	peseurt
techout	tec'hout
diàr	diwar
c'whi	c'hwi
mille 	mil 
chwi	c'hwi
marie	Mari
stéphan	Stefan
ac'hanoch	ac'hanoc'h
télégramme	telegram
nozvat	noz vat
aotroù	aotrou
skriviñ	skrivañ
warchoazh	warc'hoazh
llaer	laer
achu	echu
skzuizh	skuizh
bernn	benn
sonedagoù	sonadegoù
genoc'h	ganeoc'h
emcihañs	emichañs
vrummenn	vrumenn
skinwell	skinwel
migon	mignon
taski	taksi
jug	chug
moneizh	moneiz
c'houzhout	c'houzout
grenv	greñv
aman	amañ
dañvezioù	danvezioù
dañvez	danvez
emsalc'h	emzalc'h
stañk	stank
avañtur	avantur
seitekved	seitekvet
ugentved	ugentvet
èl	evel
hanterkantved	hanterkantvet
awalc'h	a-walc'h
marmoused	marmouzed
dishoñjal	disoñjal
tonnenn	tonenn
kaondaonet	kondaonet
unnan	unan
kantvet	kantved
gouvezet	gouezet
c'houzhout	c'houzout
diagnostics	diagnostiks
yaouankik	yaouankig
marc'hatmatoc'h	marc'hadmatoc'h
gante	ganto
hirie	hiriv
chigago	chicago
toud	tout
siezhvet	seizhvet
c'homlec'h	chomlec'h
neizhañ	neizhiañ
choulz 	 c'houlz
choant 	c'hoant 
virgulen	virgulenn
founnus	fonnus
huelgoat	Uhelgoad
arru	erru
be'h	bec'h
pa'z	p'az
pa'n	p'an
pa'm	p'am
na'm	n'am
ne'm	n'em
ne'z	n'ez
ma'm	m'am
me'm	m'em
me 'm eus	me'm eus
 'm eus	 m'eus
%	dregant
cl	santilitr
5	pemp
6	c'hwec'h
7	seiz
8	eizh
9	nav
10	dek
20	ugent
30	tregont
50	hanter-kant
60	tri ugent
70	dek ha tri ugent
80	pevar ugent
90	dek ha pevar ugent
100	kant
150	kant hanter kant
200	daou c'hant
300	tri c'hant
400	pevar c'hant
500	pemp kant
600	c'hwec'h kant
700	seizh kant
800	eizh kant
900	nav c'hant
1000	mil
